12#50
1 2 1 2 6 2 1 1 6 2 1 1 1 5 6 1 1 1 1 10 10 10 10 10 10 67 67 10 10 26 26 26 26 26 26 26 26 26 247 247 247 247 247 247 247 247 247 182 -1 -1
123 123 123 123 123 123 1 1 1 3 1 10 1 2 1 1 5 1 1 10 10 10 10 10 10 -1 -1 10 10 25 25 25 25 25 25 25 25 25 247 247 247 247 247 247 247 247 247 182 -1 -1
123 123 123 123 123 123 123 123 3 2 1 2 2 2 1 2 2 2 2 10 10 10 10 10 10 -1 -1 10 10 24 24 24 24 24 24 24 24 24 247 247 247 247 247 247 247 247 247 182 182 182
123 123 123 193 123 123 123 123 123 123 123 2 3 3 3 1 2 1 2 9 9 9 9 9 9 -1 -1 9 9 72 71 70 70 70 70 70 71 72 83 103 102 103 103 107 114 117 116 182 182 182
123 123 123 123 123 123 123 123 123 123 123 123 123 123 123 123 123 123 123 123 123 123 123 35 17 -1 -1 -1 -1 30 -1 -1 -1 -1 -1 -1 -1 -1 -1 -1 14 121 -1 122 16 13 121 182 182 182
123 123 123 123 123 123 123 123 123 123 123 123 123 123 123 123 123 123 123 123 123 123 123 -1 -1 -1 -1 -1 -1 -1 -1 -1 -1 -1 -1 -1 -1 -1 -1 -1 -1 -1 -1 -1 -1 11 -1 182 182 182
123 123 123 123 123 123 123 123 123 123 123 193 123 123 123 123 123 123 123 193 123 123 123 -1 -1 -1 -1 -1 -1 -1 -1 -1 -1 -1 -1 -1 -1 -1 -1 -1 -1 -1 -1 -1 -1 11 -1 182 182 182
123 123 123 123 123 123 123 123 123 123 123 123 123 123 123 123 123 123 123 123 123 123 123 123 123 -1 -1 -1 -1 -1 -1 -1 -1 -1 -1 -1 -1 -1 -1 -1 -1 -1 -1 -1 -1 -1 -1 182 182 182
123 123 123 123 123 123 123 123 123 123 123 123 123 123 123 123 123 123 123 123 123 123 123 123 123 -1 -1 -1 -1 -1 -1 -1 -1 -1 -1 -1 -1 -1 -1 -1 -1 -1 -1 -1 -1 -1 -1 182 182 182
123 123 123 123 123 123 123 123 123 123 123 123 123 123 123 123 123 123 123 123 123 123 123 123 123 123 -1 -1 -1 -1 -1 -1 -1 -1 -1 -1 -1 -1 -1 -1 -1 -1 -1 -1 -1 -1 -1 182 182 182
123 123 123 123 123 123 123 123 123 123 123 123 123 123 123 123 123 123 123 123 123 123 123 123 123 123 123 -1 -1 -1 -1 -1 -1 -1 -1 -1 -1 -1 -1 -1 -1 -1 -1 -1 -1 -1 -1 -1 -1 -1
123 123 123 123 123 123 123 123 123 123 123 123 123 123 123 123 123 123 123 123 123 123 123 123 123 123 123 -1 -1 -1 -1 -1 -1 -1 -1 -1 -1 -1 -1 -1 -1 -1 -1 -1 -1 -1 -1 -1 -1 -1
9
252 36 504 72 1
504 108 144 72 1
720 180 288 72 1
1296 252 1008 72 1
1764 108 72 216 1
2664 252 1440 72 1
3420 453 73 466 1
1980 108 72 216 1
1872 180 144 72 1
0
